NO texture/000000.png.png
SO texture/0000FF.png.png
WE texture/00FF00.png.png
EA texture/FF0000.png.png

F 42,42,42
C 27,22,32

111111
100001
1100W1
100001
111111
